{
	dirt: [.4, .3, 0],
	dirt2: [.3, .2, 0],
	grass: [.2, .4, 0],
	sky: [1, .6, .5],
	special: [[.95, 0.5, 0.5], [1, 0, 1]],
	caryover: false,
	map:
	[
"###############################################################",
"####                                                         ##",
"###                                                          ##",
"##                                                           ##",
"##                                                           ##",
"##                                                           ##",
"##                                                           ##",
"##                                                 *         ##",
"#                                                            ##",
"#     $ $ $ $   oooo                                         ##",
"######oooooooo###################ooooooooooooo#################"
	]
}
