{
	dirt: [.4, .4, 0],
	dirt2: [.3, .3, 0],
	grass: [.2, .4, 0],
	sky: [1, .7, .4],
	special: [[.95, 0.5, 0.5], [1, 0, 1]],
	caryover: false,
	map:
	[
"###############################################################",
"####                     0                                   ##",
"###                      0                                   ##",
"##                       0                        *          ##",
"#                        0                                   ##",
"#     $ $ $ $   oooo     0                                   ##",
"######oooooooo###################ooooooooooooo#################"
	]
}
