{
	dirt: [.4, .4, 0],
	dirt2: [.3, .3, 0],
	grass: [.2, .4, 0],
	sky: [.4, .3, .6],
	special: [[.35, 0, 0], [1, 0, 1]],
	map:
	[
"###############################################################",
"#####################                                 #########",
"############                                          #########",
"#############                                       ###########",
"###########                                  ##################",
"#########                                  ####################",
"#######                                              ##########",
"########                           ####                  ######",
"######                         ooo######                #######",
"########                        ##########              #######",
"#####                          ###########               ######",
"##########                   #############              #######",
"#########                   ###############             #######",
"######                        ##############          #########",
"#####                    o#################              ######",
"######                  #####################           #######",
"####                     #####              1        ##########",
"###                      0                  1       ###########",
"##                       0                  1      ############",
"#                        0                  1     ##    #######",
"#     $ $ $ $   oooo     0                  1    ##      ######",
"######oooooooo###################ooooooooooooo#################"
	]
}
